NO textures/netherrack.png
SO textures/nether_brick.png
WE textures/red_nether_brick.png    
EA textures/cracked_nether_bricks.png

F 107,2,2
C 163,34,62

111                                                                                       111
1011                                                                                     1101
10011                                                                                   11001
100011111111                                                                     111111110001
100000000001111111                                                         111111100000000001
10000000000000000111111                                               11111100000000000000001
100000000000000000000011111                                       111110000000000000000000001
1000000000000000000000000011111                               1111100000000000000000000000001
1000000000000000000000000000001                               1000000000000000000000000000001
111110000000000000000000000000111111111111111111111111111111111000000000000000000000000011111
111000000000000000000000000000000000000000000000000000000000000000000000000000000000000000111
110011000000001111000111111111100011111111111110S00110000001100011111111110001111111100000011
100011110000001111000110000000000000000111000000000110000001100011000000000001100000011000001
100011110000001111000110000000000000000111000000000110000001100011000000000001100000011000001
100011111100001111000111111000000000000111000000000111111111100011111100000001100000011000001
100011111111001111000110000000000000000111000000000110000001100011000000000001111111100000001
100011111111111111000110000000000000000111000000000110000001100011000000000001100000011000001
100011110000111111000110000000000000000111000000000110000001100011000000000001100000011000001
100011110000001111000110000000000000000111000000000110000001100011000000000001100000011000001
110011110000000011000111111111100000000111000000000110000001100011111111110001100000000110011
111000000000000000000000000000000000000000000000000000000000000000000000000000000000000000111
111110000000000000000000000000000000000001000000000000000000000000000010000000000000000011111
100000000000010000000000000001110000000011100000100000010000000110000111000001000000100000001
110001000100010010010001110111 1000011111 1000011100011 1000001111001111100001100001100000011
 11001000111110010111011 111   110011      11111 11011  1000001  1001    11111100001 1000001
  11010011   110111 111         1011              101   1100011  1111         110011 1000011
    11111     111               111               111    11111                 1111  111111
